Mr Villazon
Class List Report : 7w/Cp2 as of 01/09/2022
Full Name	Gender	Pupil Premium Indicator
Akintayo, Rio	Male	No
Boulger, Rocco	Male	No
Chamberlain, Ruby	Female	No
Dahal, Aarav	Male	No
Dang, Jacob	Male	No
El Baaj, Thomas	Male	No
Eneh, Kamsi	Male	No
Gorin, Nicky	Male	No
Hoang, Ruby	Female	No
Jain, Naina	Female	No
Loftus, Nikolaos	Male	No
Manisegaran, Seiyoane	Male	No
Maste, Aarush	Male	No
Messam-Gates, Thomas	Male	No
Otto, Princess	Female	No
Paice, Louie	Male	No
Quinn, Josh	Male	No
Shaw, Grace	Female	No
Sherchan, Joeshlynn	Female	No
Wariabharaj, Kimran	Female	No
Wise, Finley	Male	No
Males: 14 Females : 7
Class List Report : 7x/Cp1 as of 01/09/2022
Full Name	Gender	Pupil Premium Indicator
Adeyemi, Mary	Female	No
Almarales, Arelys	Female	No
Berglund, Lilla	Female	No
Bhattarai, Kebish	Male	No
Brooker, Zack	Male	No
De Jongh Martin, Fabio	Male	No
Dimitrov, Velizar	Male	No
Donald, Jess	Female	No
Dutchuk, Mark	Male	No
Fox, Ciara	Female	No
Klotins, Peters	Male	No
Hilton, Harrison	Male	No
Jolly, Joshua	Male	No
Kolvankar, Atharva	Male	No
Kulbis, Gerda	Female	No
Macklin, Rory	Male	No
Male, Christopher	Male	No
Mitchell, Jack	Male	No
Neupane, Samraat	Male	No
Patel, Aaran	Male	No
Pokhrel, Shreya	Female	No
Males: 14 Females : 7
Class List Report : 7x/Cp3 as of 01/09/2022
Full Name	Gender	Pupil Premium Indicator
Brooks, Anthony	Male	No
Graham, Eliza	Female	No
Hammond, Jason	Male	No
Hasan, Adyan	Male	No
Hoang, Ethan	Male	No
Hyoju, Kairav	Male	No
Jennings, Darcy	Female	No
Kainth, Krish	Male	No
Mian, Yousaf	Male	No
Moss, Daniel	Male	No
Okedeyi, Samuel	Male	No
Oliver-Kingful, Annabelle	Female	No
Prasadh, Dev	Male	No
Quinn, Olivia	Female	No
Rimmington, Aarun	Male	No
Shrestha, Krisha	Female	No
Sohan, Fardeen	Male	No
Soyinka, Biyi	Male	No
Vallabhaneni, Oscar	Male	No
Younis-Jordan, Amelia	Female	No
Yu, Jun	Male	No
Zherebtsova, Anna	Female	No
Males: 15 Females : 7
Class List Report : 7y/Cp2 as of 01/09/2022
Full Name	Gender	Pupil Premium Indicator
Agrawal, Yatharth	Male	No
Bartlett, Jack	Male	No
Chadha, Ayrton	Male	No
Constable, Lucas	Male	No
Edwards, Alfred	Male	No
Fletcher, Katy	Female	No
Giri, Inesh	Male	No
Gowlett, Zara	Female	No
Ivashkevitch, Olivia	Female	No
Jeffries, Elsie	Female	No
Nalepa, Florie	Female	No
Osborn, Casey	Female	No
Philip-Bakare, Mayomikun	Male	No
Pitts, George	Male	No
Pompei, Radleigh	Male	No
Rahman, Aarib	Male	No
Savage, Freya	Female	No
Shrestha, Nibodh	Male	No
Sulcas, Adam	Male	No
Virk, Josh	Male	No
Wagland, James	Male	No
Males: 14 Females : 7
Class List Report : 8w/Cp1 as of 01/09/2022
Full Name	Gender	Pupil Premium Indicator
Akrah, Toby	Male	No
Albu, Adam	Male	No
Banks, Olive	Female	No
Barnes, George	Male	No
Bondar-Zamorskis, Nikita	Male	No
Chappell, Sam	Male	No
Dhanak, Jia	Female	No
Furmage, Erin	Female	No
Gainda, Kieran	Male	No
Hall, Gregory	Male	No
Jinse, Roshan	Male	No
Khan, Zayan	Male	No
Konosonoks, Max	Male	No
Kupa, Misir	Male	No
Lambin, Daniel	Male	No
Liu, Hongzhi	Male	No
Long, Leonardo	Male	No
Manivannan, Arjun	Male	No
Martin, Luke	Male	No
McAvoy, Sophia	Female	No
Mofakham, Yasmin	Female	No
Males: 16 Females : 5
Class List Report : 8x/Cp1 as of 01/09/2022
Full Name	Gender	Pupil Premium Indicator
Ahanon, Jesse	Male	No
Armstrong, Jake	Male	No
Bloom, Benan	Male	No
Bono, Valentino	Male	No
Bracken, Dhylan	Male	No
Cao, Lisa	Female	No
Dhunnookchand, Jonah	Male	No
Dimitrov, Alex	Male	No
Hall, Emily	Female	No
Houston, Danti	Female	No
Jerome, Teddy	Male	No
Kumar, Dhruv	Male	No
Lim, Shuen	Male	No
Lloyd, Sophia	Female	No
Matheson, Rayon	Male	No
Muhaso, Tadana	Male	No
Okon-Rocha, Antoni	Male	No
Onyeanusi, Munachiso	Male	No
Pasca, Gratian	Male	No
Pietrzak, Jenna-Leigh	Female	No
Polyarush, Andrey	Male	No
Preece, Finley	Male	No
Males: 17 Females : 5
Class List Report : 8x/Cp2 as of 01/09/2022
Full Name	Gender	Pupil Premium Indicator
Azad, Zidan	Male	No
Azodoh, Ikenna	Male	No
Bense, William	Male	No
Blowfield, Jack	Male	No
Chan, Emily	Female	No
Cook, George	Male	No
Dahiya, Rishi	Male	No
Day, Norwyn	Male	No
Fernandes, Luke	Male	No
Gough, Miley	Female	No
Neligan, Sofia	Female	No
Riches Foot, Gabriel	Male	No
Rizov, Alexander	Male	No
Salyga, Edwin	Male	No
Saravana, Karthik	Male	No
Selby-Boothroyd, Tabitha	Female	No
Sutu, Maya	Female	No
Tyler, Finley	Male	No
Virk, Shraya	Female	No
Xie, Tianming	Male	No
Zhou-Pettman, Caden	Male	No
Males: 15 Females : 6
Class List Report : 8y/Cp1 as of 01/09/2022
Full Name	Gender	Pupil Premium Indicator
Allen, Sophie	Female	No
Baker, Dylan	Male	No
Bhardwaj, Nihal	Male	No
Bowring, Benjamin	Male	No
Chalayil, Jake	Male	No
Chu, Jay	Male	No
Drake, Lucas	Male	No
Fitton, Sam	Male	No
Fosh, Abi	Female	No
Franklin, Luca	Male	No
Gatfield, Ethan	Male	No
Graham, Amy	Female	No
Grigoreva, Diana	Female	No
Hicks, Lucas	Male	No
Hughes, Oliver	Male	No
Janse van Rensburg, Aiden	Male	No
Kapu, Devine	Female	No
Kryukova, Laura	Female	No
Malhotra, Arjun	Male	No
Manjure, Dev	Male	No
Mohamed, Aman	Male	No
Males: 15 Females : 6
Class List Report : 9A/Cp as of 01/09/2022
Full Name	Gender	Pupil Premium Indicator
Abdelghaffar, Samy	Male	No
Blair-Hicks, Jonah	Male	No
Chawich, Omar	Male	No
Chu, Steven	Male	No
Gupta, Udbhav	Male	No
Hicks, Amber	Female	No
Jeffrey, Theo	Male	No
Kelpie, Kieron	Male	No
Kidby, Rebecca	Female	No
Krishnan, Anshika	Female	No
Laming, Millie	Female	No
Luong, Angela	Female	No
Matharu, Rohan	Male	No
McCann, Caleb	Male	No
Morgan, Oliver	Male	No
Oliver-Kingful, Manuel	Male	No
Pai, Anagha	Female	No
Pathmaruban, Rohisan	Male	No
Ragg, Daniel	Male	No
Raiyan, Ahmed	Male	No
Sehota, Arjan	Male	No
Smith, Hannah	Female	No
Talukder, Nadid	Male	No
Tanner, Keiton	Male	No
Tyler, Ella	Female	No
Wymark, Blake	Male	No
Males: 18 Females : 8
Class List Report : 9C/Cp as of 01/09/2022
Full Name	Gender	Pupil Premium Indicator
Adekoya, Angel	Female	No
Akhtar, Zakariya	Male	No
Androshchuk, Diana	Female	No
Barnes, Joel	Male	No
Carter, Abigail	Female	No
Chongbang, Nimisha	Female	No
Dutta, Avaani	Female	No
El-Labban, Adam	Male	No
Furlong, Charlie	Female	No
George, Ben	Male	No
Gurung, Siddharth	Male	No
Huang, Sophie	Female	No
Islam, Saimom	Male	No
Izekor, Marvel	Male	No
Lane, Ava	Female	No
Malik, Abdullah	Male	No
Matthews, Dexter	Male	No
Mian, Zaki	Male	No
Norrington, James	Male	No
O'Grady-Hills, Keir	Male	No
Orimoloye, Tobi	Male	No
Sasiseelan, Sanujan	Male	No
Sirco, Emily	Female	No
Vekeria, Aydan	Male	No
Vrionides, James	Male	No
Males: 16 Females : 9
Class List Report : 9E/Cp as of 01/09/2022
Full Name	Gender	Pupil Premium Indicator
Ahmad, Aliza	Female	No
Arendt, Tymon	Male	No
Atwal, Aman	Male	No
Boyd, James	Male	No
Brett, Sam	Male	No
Chance, Jude	Male	No
Evans, Oscar	Male	No
Fortt, Lucy	Female	No
Fosh, Sophie	Female	No
Long, John	Male	No
Lopez, Maddison	Female	No
Matharu, Nimrat	Female	No
Mensa-Bonsu, Jade	Female	No
Mitchev, Yoan	Male	No
Mukasa, Noah	Male	No
O'Grady-Hills, Lewis	Male	No
Ostrowski, Hana	Female	No
Paul-Taiwo, Omolade	Male	No
Schreiner, Lukas	Male	No
Selfi, Zahra	Female	No
Sharma, Aaron	Male	No
Sivachandra, Nalin	Male	No
Steininger, Finlay	Male	No
Stoyanov, Martin	Male	No
Taflaj, Maxim	Male	No
Males: 17 Females : 8
Class List Report : 9G/Cp as of 01/09/2022
Full Name	Gender	Pupil Premium Indicator
Achu-Mofor, Harvey	Male	No
Aloomian, Amelia	Female	No
Baker, Claudia	Female	No
Bennett, Liam	Male	No
Bryan, Lewis	Male	No
Davis, Jessica	Female	No
Ese-Owede, Leroy	Male	No
Eshaan, Eshfaqur	Male	No
Faola, Anthony	Male	No
Farram, Sidney	Male	No
Gee, Nathan	Male	No
Hoyte, Yuri	Male	No
Kenny, Cameron	Male	No
Li, Alex	Male	No
Mercer, Tom	Male	No
Mirza, Aggeliki	Female	No
Musov, Berad	Male	No
Newton, Eloise	Female	No
Nguyen, Mia	Female	No
Owen, Raef	Male	No
Patel, Krishaal	Male	No
Quinn, Daniel	Male	No
Rygielska, Sofie	Female	No
Vacarciuc, Oscar	Male	No
Males: 17 Females : 7
Class List Report : 9I/Cp as of 01/09/2022
Full Name	Gender	Pupil Premium Indicator
Abrol, Karan	Male	No
Alwan, Sienna	Female	No
Balogun, Jonathan	Male	No
Benedict, William	Male	No
Berglund, Alfred	Male	No
Chukwu-Ike, Shammael	Male	No
Clements, Bess	Female	No
Coakley, Oliver	Male	No
Dalrymple-Hayfron, Zach	Male	No
Danilczuk, Jerzy	Male	No
Davidson, Adam	Male	No
De Souza-Plans, Rafael	Male	No
Evans, Layla	Female	No
Foley, Jessica	Female	No
Ghaffar, Zayan	Male	No
Huggett, Isabella	Female	No
Kerans, Christian	Male	No
Manolakou, Astarti	Female	No
Mendjeli, Naima	Female	No
Saeed, Subhan	Male	No
Sault, Lenny	Male	No
Stoyanova, Anastasia	Female	No
Ward, Isabella	Female	No
Ward, Sam	Male	No
Males: 15 Females : 9
Class List Report : 10A/Cp1 as of 01/09/2022
Full Name	Gender	Pupil Premium Indicator
Adelasoye, Mubarak	Male	No
Blankson, Edwin	Male	No
Bulavitchi, Luca	Male	No
Chin, Gen	Male	No
Cotton, Jack	Male	No
Daniele, Matias	Male	No
Despabiladeras, Paul	Male	No
Grime, Stanley	Male	No
Hemmise, Seth	Male	No
Khodeir, Adam	Male	No
Klotins, Viktors	Male	No
Li, Alfred	Male	No
Marufov, Behzod	Male	No
Mazieres, Clarisse	Female	No
Miao, George	Male	No
Nguyen, Bao	Male	No
Norris, Isabelle	Female	No
Ohen, Jonathan	Male	No
Oshogwe, Jesse	Male	No
Ragunathan, Agash	Male	No
Rehal, Hari	Male	No
Ryan, Callum	Male	No
Sangha, Dhiren	Male	No
Sawczuk, Jan	Male	No
Smirnova, Elizabeth	Female	No
Smythe, Nicholas	Male	No
Tran, Lincoln	Male	No
Males: 24 Females : 3
Class List Report : 10C/Cp1 as of 01/09/2022
Full Name	Gender	Pupil Premium Indicator
Anowar, Namir	Male	No
Chalayil, Jayden	Male	No
Chikovsky, Arthur	Male	No
Crawford, Elijah	Male	No
Creedy, Callum	Male	No
Ekunola, Tolu	Male	No
Gearing, Edward	Male	No
Hall, Joseph	Male	No
Hin, Cynthia	Female	No
Jackson, Matilda	Female	No
Kamande, Melchior	Male	No
Lewis, Peter	Male	No
Longmate, Joshua	Male	No
Maksym, Greg	Male	No
Mazumder, Musavvir	Male	No
Nehan, Farheen	Male	No
Oyebisi, Elias	Male	No
Pandey, Shivin	Male	No
Raghu, Rohan	Male	No
Rioland, Antoine	Male	No
Shrestha, Kasper	Male	No
Stanzys, Tomas	Male	No
Stepanova, Leila	Female	No
Tran, Tony	Male	No
Wagle, Aryan	Male	No
Males: 22 Females : 3
Class List Report : 11C/Cp1 as of 01/09/2022
Full Name	Gender	Pupil Premium Indicator
Abbate, Ethan	Male	No
Adeyemi, Emmanuel	Male	No
Akhtar Gordon, Isaam	Male	No
Bourlet, Edward	Male	No
Bowring, Sam	Male	No
Conway, James	Male	No
Dalipi, Haris	Male	No
Domi, Mattia	Male	No
Durand, Aimy	Female	No
Ganagenthiran, Sajan	Male	No
Gnaneswaran, Kibee	Male	No
Graham, Theodore	Male	No
Guaydier, Sebastian	Male	No
Inpakeethan, Akshyan	Male	No
Johnson, Max	Male	No
Keeley, Kai	Male	No
Kiley, Aaron	Male	No
Maksym, Elena	Female	No
Matthews, Callum	Male	No
Miah, Sifat	Male	No
Oladimeji, Israel	Male	No
Rackstraw, Max	Male	No
Ramkumar, Amrit	Male	No
Shekar, Yuvan	Male	No
Sivakumar, Dishanth	Male	No
Tyagi, Ronak	Male	No
Vilvarajah, Sisanth	Male	No
Wardle, Jamie	Male	No
Xu, Kaijun	Male	No
Yuen, Lawrence	Male	No
Males: 28 Females : 2
Class List Report : 12D/CpH as of 01/09/2022
Full Name	Gender	Pupil Premium Indicator
Arkwright, Jack	Male	No
Atigogo, Joseph	Male	No
Bakundukize, Joseph	Male	No
Batt, Hannah	Female	No
Boles, Oliver	Male	No
Briggs, Maximilien	Male	No
Cassell, William	Male	No
Dalrymple, Tom	Male	No
Doherty, Dezel	Male	No
Frazer, Olivia	Female	No
Jokomba, Elizabeth	Female	No
Karasimov, Malin	Male	No
Kheltubnishvili, Konstantinos	Male	No
Kidby, Michael	Male	No
Lawlor, Zara	Female	No
Maj, Zuzia	Female	No
Malhotra, Naman	Male	No
Medushivskyi, Yevhenii	Male	No
Morris, Joshua	Male	No
Mukasa, Isiah	Male	No
Nebeolisa, Ikechukwu	Male	No
Orton, Niall	Male	No
Osman, Hashim	Male	No
Ozgur, Cansu	Female	No
Paci, Leon	Male	No
Pecula, Jakub	Male	No
Sheel, Pranshu	Male	No
Solan, Daniel	Male	No
Staniforth, Jamie	Male	No
Steel, Freddy	Male	No
Swann, Matthew	Male	No
Tetteh, Benjamin	Male	No
Tettey, Joelle	Female	No
Thi, Van	Male	No
West, Billy	Male	No
Males: 28 Females : 7
Class List Report : 13B/CpH as of 01/09/2022
Full Name	Gender	Pupil Premium Indicator
Alwan, Matthew	Male	No
Amrouche, Neila	Female	No
Anthony, Godwill	Male	No
Asante, Emmanuel	Male	No
Ashton, Max	Male	No
Bangura, Nathan	Male	No
Bartkevych, Maximilian	Male	No
Fanawopo, Samuel	Male	No
Faulkner, Matthew	Male	No
Hurley, Jake	Male	No
Huynh, Samuel	Male	No
Ionita, Alexandru	Male	No
Kharal, Girish	Male	No
Koirala, Lissan	Male	No
Kolev, Dobrin	Male	No
Nastase, Cristian	Male	No
Panda, Mayukhi	Female	No
Paska, Oleg	Male	No
Rawile, Eddie	Male	No
Sesay, Mistura	Female	No
Sureskumar, Varunegha	Female	No
Surpin, Kenith	Male	No
Syms, George	Male	No
Walker, Ben	Male	No
Zamonov, Isfandiyor	Male	No
Males: 21 Females : 4